1111111111111111111
1111CCC10000C1C0001
11E1CCC100001C10001
1101101100101010101
10001010001C1C1C101
1000000000101010101
1000000000000000001
1100111111111111101
111010C010C010C0101
1110101010101010101
1PC00010C010C010C01
1111111111111111111
